11111111111111
10400000200301
10000001111101
10014001   141
10000001111101
10040000400001
10000000111111
100110001
100000001111
104111102401
10111 111111
111