1111111111
1200001001
1000001001
1111001101
1000000001
1000001001
1000100101
1111111111