1111111111
1240001001
1010001001
1003001101
1111000001
1000001001
1000100101
1111111111