 1111111111111
11000000000001
10000001111101
10010011   101
10000001111101
10000000000001
10000000111111
100110001
100000001111
100111100001
10111 111111
111