1111111111
1240001001
1010001401
1003001101
1111040001
1000401401
1040100101
1111111111
